-1
@010@010@
224134412
121134414
414231422
222232114
242434441
