-1
####@@@@
###11213
##131213
#1132322
3232232#
223213##
33131###
1313####
