#1#1#1
#22#11
122111
11#111
112211
112221
111111
