111111
122111
122111
111111
112211
112221
111111
